media_outlet,positive,negative,balanced,informational,total
La Opini√≥n,149,296,142,101,688
Wall Street Journal,137,118,125,79,459
Univision,226,484,225,159,1094
San Diego Union Tribune,60,24,18,17,119
Fox News,73,102,58,60,293
Washington Post,52,97,56,50,255
CNN,127,160,102,88,477
USA Today,32,23,14,22,91
The Daily Beast,9,50,13,10,82
Bloomberg,251,183,158,119,711
Fusion,48,86,54,49,237
NPR,20,30,12,14,76
Dallas Morning News,40,34,24,31,129
TIME,26,30,17,17,90
Forbes,97,56,72,37,262
Christian Science Monitor,19,15,21,7,62
NBC News,23,34,19,22,98
Huffington Post,232,344,219,85,880
New York Times,90,129,74,62,355
Houston Chronicle,40,32,31,24,127
Los Angeles Times,66,75,45,45,231
San Antonio Express News,28,22,14,16,80
Arizona Daily Star,32,15,6,8,61
Vice News,17,169,44,12,242